1111111111111
1000000100001
1000C00100011
11000000000E1
100001100V001
1PC0011000001
1000011000001
1111111111111