111111111111111111111111
1C1100000000000000011111
1000000001C0100000001C11
111100000111100000111011
100000000000100000000011
100000000011100000111111
100000000010100000000001
100000000011100000000001
1000010000000010000000E1
100000001111000000000001
10P000001C11000000000001
100000001011000000000001
111111111000000000000001
1C0000000000000000000001
111111111111111111111111