1111111
1000001
1C000E1
10000V1
1P00001
1110111