111111111111111111111111
101100000000000000011111
10000V00010V100000001011
111100000111100000111011
100000000000100000000011
100011000011100000111111
100001000010100000000001
10000000001110000C000001
1000010000000010000000E1
100000001111000000000001
10P000001011000001111101
100000001011000001VVV101
111111111000000001V1V101
1000000000V0000001VVV101
111111111111111111111111