111111111111111111111111111111
100000000000000000000000000001
100000000111000111111111110001
100000011111000111111111100001
100000111011000111000011100001
100001110011000000000111000001
100011100011000000001110000001
100111000011000000011100000001
100110000111000000111000000001
101111111111100001110000000001
10C000001110000011100000000001
1P0000001110000111000000000001
10000E001110001111111111110001
100000001110001111111111110001
100000000000000000000000000001
111111111111111111111111111111