########################################
#.........................#............#
#.#####.#####.#.#####.#####.#.#####.####
#.#####.#####.#.#####.#####.#.#####.####
#......................................#
#.#####.#####.#####.#.#####.#####.####.#
#.#####.#####.#####.#.#####.#####.####.#
#......................................#
#.#####.#.#####.#.#####.#.#####.#.####.#
#.#####.#.#####.#.#####.#.#####.#.####.#
#..................................#####
########################################