1111111111111
1000000000001
1000C00100001
10000000000E1
100001000V001
1PC0010000001
1000010000001
1111111111111